1111111111111
10010P000E0C1
10P0011111001
1P0011E000P01
1111111111111