1111111111111
10010C00010C1
1000000000011
1P0011E000C01
1111111111111