1111111111111
10010000010C1
1000000000011
1P0011E000001
1111111111111